NO ./textures/north.xpm
EA ./textures/east.xpm
SO ./textures/south.xpm
WE ./textures/west.xpm

F 220, 100, 0
C 225, 30, 0

11111111111111
11111111000001
10000000000001
100000000E0001
10000000000001
11111111000001
11111111111111