NO ./TEXTURES/north.xpm
EA ./TEXTURES/east.xpm
SO ./TEXTURES/south.xpm
WE ./TEXTURES/west.xpm

F 0, 20, 100
C 225, 30, 0

11111111111111
11111111000001
10000000100001
100000000N0001
10000000000001
11111111000001
11111111111111