NO ./textures/north.xpm
EA ./textures/east.xpm
SO ./textures/south.xpm
WE ./textures/west.xpm

F 220, 100, 0
C 225, 30, 0

 111111111
100010001
1000N1111
100001
111111

fd