NO ./textures/north.xpm
EA ./textures/east.xpm
SO ./textures/south.xpm
WE ./textures/west.xpm

F 220, 100, 0
C 225, 30, 0

111111111111111111111111
111111111111111111000001
100000000000000000000001
1000000000000000000W0001
100000000000000000000001
111111111111111111000001
111111111111111111111111