WE ./maps/textures/west.xpm

NO ./maps/textures/north.xpm

SO ./maps/textures/south.xpm

EA ./maps/textures/east.xpm

F 220,100,0

C 225,30,0

   111111111
    1000001
     10N01
      101
       1
