NO ./TEXTURES/north.xpm
WE ./TEXTURES/west.xpm
EA ./TEXTURES/east.xpm
SO ./TEXTURES/south.xpm



F 0, 20, 44
C 225, 30, 0

111111111111111111111111111
111110110000000000000000001
100000001000000000000000001
10000N000000111110000000001
1000000000111   10001111111
111111110000111110000000001
111111111111100000000000001
111111111111111111111111111